###########################
#            *            #
# ####################### #
# ####################### #
# ####################### #
# ####################### #
# ####################### #
# ####################### #
# ####################### #
# ####################### #
# ####################### #
# ####################### #
# ####################### #
# ####################### #
# ####################### #
# ####################### #
# ####################### #
# ####################### #
# ####################### #
# ####################### #
# ####################### #
# ####################### #
# ####################### #
# ####################### #
# ####################### #
#            P            #
###########################