###########################
#                         #
#                         #
#      ##    ##     ##    #
#      ##    ##     ##    #
#                         #
#                         #
#    ##   ###             #
#    ##         ##        #
#                         #
#                         #
#                         #
#                         #
#         PBBN            #
#   *          ##         #
#              ##         #
#                         #
#                         #
#       ##                #
#       ##                #
#                         #
#                         #
#              ##         #
#                         #
#     ##                  #
#                         #
###########################